11111111111111111111111111111111
10000000000000000C00000000000001
1P000000000000E00000000000000001
10000000000C00000000100000000001
10000000000000000000000000000001
10000C00000000000000000000000001
1000000000C000000000000000000101
10000000000000000000000000000001
1000000000C000000000000000000001
10000000000000000001000000C00001
10000000000000010000000000000001
100000000C0000000000000000000001
10000C00000000000000000000000001
11111111111111111111111111111111
