11111111111111111111
10000000100100000011
10000000000000000101
100000C00000000C1001
11010E00000000000001
100100000C0C01100001
10000000000000000001
10010000000100010101
100000C0000010P00001
10100010C00000000001
11000100000000000101
11111111111111111111