111111111111
10C000000001
10110100C001
11001C000001
10001P0C0011
101110001011
1001011C0001
100011000001
110E00000001
1C0000000011
100000001001
111111111111