111111111111111111111111111111
1000000C0C00000100000000000001
100000001010000000000000000001
1000000000000000000000000C0101
10000E100000000000000000100001
10000000000000010C001000000001
100000000010000000000P000C0101
101000000000000000000100000001
100000000000000000000001000001
1000010000000100C0001000000001
100000010001000000000000000011
1000000001000000C0000000000001
100000000100010001101000000001
111111111111111111111111111111